1111111111111111111111111111111111111111111111111111111
1P000001000000C1000000000000000000000000000000000000001
111110010001111000000CC0000001100000000CC00000000000001
1000C00100000000000000000011111111000000000001111000001
1000011111111000000111111111111111111111000000001000001
1000000000000000000000000000000000000000000000001000001
1111110000000111111100000000000000000001110000001000001
1000000000000000001111111111111000000001110000001000001
1000000111110000001100000000000000000001110000001000001
1000000111110000001100000000000000C00001110000001000001
1000000111110000001100011000000000000001110000001000001
1000000111110000001100011111100000000001110000001000001
1000000000000000001100011111100000000001110000001000001
111111111111000000110000C001100000C0000111000000C00CC01
100000000011000000110000000110000000000111000000C00CC01
1000CC0000110000001111111111100000C00001110000001000001
1000CC0000110000000000000000000000000001110000001111111
1000000000000000000000000000000000C00001110000000000001
1111111111111111111111111111111111111111111111111111111