11111111111111111111
100000000P0000000001
10000000000000000001
1000C0000000E0000001
10000000000000000001
10000000000000000001
11111111111111111111